-	ー
,	、
;	っ
.	。
[	「
]	」
/	・
a	あ
ba	ば
bd	べん
be	べ
bh	ぶう
bi	び
bj	ぶん
bk	びん
bl	ぼん
bn	ばん
bo	ぼ
bp	ぼう
bq	ばい
bt	びと
bu	ぶ
bw	べい
bya	びゃ
byd	びぇん
bye	びぇ
byh	びゅう
byj	びゅん
byl	びょん
byn	びゃん
byo	びょ
byp	びょう
byq	びゃい
byu	びゅ
byw	びぇい
byz	びゃん
bz	ばん
ca	ちゃ
cba	ちぇば
cbd	ちぇべん
cbe	ちぇべ
cbh	ちぇぶう
cbi	ちぇび
cbj	ちぇぶん
cbk	ちぇびん
cbl	ちぇぼん
cbn	ちぇばん
cbo	ちぇぼ
cbp	ちぇぼう
cbq	ちぇばい
cbu	ちぇぶ
cbw	ちぇべい
cbz	ちぇばん
cd	ちぇん
ce	ちぇ
cf	ちぇ
ch	ちゅう
cj	ちゅん
cl	ちょん
cn	ちゃん
co	ちょ
cp	ちょう
cq	ちゃい
cra	ちぇら
crd	ちぇれん
cre	ちぇれ
crh	ちぇるう
cri	ちぇり
crj	ちぇるん
crk	ちぇりん
crl	ちぇろん
crn	ちぇらん
cro	ちぇろ
crp	ちぇろう
crq	ちぇらい
cru	ちぇる
crw	ちぇれい
crz	ちぇらん
cta	ちぇた
ctd	ちぇてん
cte	ちぇて
cth	ちぇつう
cti	ちぇち
ctj	ちぇつん
ctk	ちぇちん
ctl	ちぇとん
ctn	ちぇたん
cto	ちぇと
ctp	ちぇとう
ctq	ちぇたい
ctu	ちぇつ
ctw	ちぇてい
ctz	ちぇたん
cu	ちゅ
cw	ちぇい
cz	ちゃん
da	だ
dba	でば
dbd	でべん
dbe	でべ
dbh	でぶう
dbi	でび
dbj	でぶん
dbk	でびん
dbl	でぼん
dbn	でばん
dbo	でぼ
dbp	でぼう
dbq	でばい
dbu	でぶ
dbw	でべい
dbya	でびゃ
dbyh	でびゅう
dbyo	でびょ
dbyp	でびょう
dbyu	でびゅ
dbz	でばん
dci	でぃ
dcj	どぅん
dck	でぃん
dcu	どぅ
dd	でん
de	で
df	で
dga	でゃ
dgo	でょ
dgu	でゅ
dh	づう
di	ぢ
dj	づん
dk	ぢん
dl	どん
dm	でも
dn	だん
do	ど
dp	どう
dq	だい
dra	でら
drd	でれん
dre	でれ
drh	でるう
dri	でり
drj	でるん
drk	でりん
drl	でろん
drn	でらん
dro	でろ
drp	でろう
drq	でらい
drr	でられ
drs	でられ
dru	でる
drw	でれい
drya	でりゃ
dryh	でりゅう
dryo	でりょ
dryp	でりょう
dryu	でりゅ
drz	でらん
ds	です
dta	でた
dtd	でてん
dte	でて
dtga	でつぁ
dtge	でつぇ
dtgi	でてぃ
dtgj	でとぅん
dtgk	でてぃん
dtgu	でとぅ
dth	でつう
dti	でち
dtj	でつん
dtk	でちん
dtl	でとん
dtm	でため
dtn	でたん
dto	でと
dtp	でとう
dtq	でたい
dtt	でたち
dtu	でつ
dtw	でてい
dtya	でつぁ
dtye	でつぇ
dtyi	でてぃ
dtyj	でとぅん
dtyk	でてぃん
dtyu	でとぅ
dtz	でたん
du	づ
dv	でれ
dw	でい
dya	ぢゃ
dyd	ぢぇん
dye	ぢぇ
dyh	ぢゅう
dyi	でぃ
dyj	ぢゅん
dyk	でぃん
dyl	ぢょん
dyn	ぢゃん
dyo	ぢょ
dyp	ぢょう
dyq	ぢゃい
dyu	ぢゅ
dyw	ぢぇい
dyz	ぢゃん
dz	だん
e	え
fa	ふぁ
fd	ふぇん
fe	ふぇ
fh	ふう
fi	ふぃ
fj	ふん
fk	ふぃん
fl	ふぉん
fn	ふぁん
fo	ふぉ
fpa	っぱ
fpd	っぺん
fpe	っぺ
fpf	っぽん
fpga	っぴゃ
fpgd	っぴぇん
fpgf	っぴょう
fpgh	っぴゅう
fpgj	っぴゅん
fpgl	っぴょん
fpgn	っぴゃん
fpgo	っぴょ
fpgp	っぴょう
fpgq	っぴゃい
fpgu	っぴゅ
fpgw	っぴぇい
fpgz	っぴゃん
fph	っぷう
fpi	っぴ
fpj	っぷん
fpk	っぴん
fpl	っぽん
fpn	っぱん
fpo	っぽ
fpp	っぽう
fpq	っぱい
fpu	っぷ
fpw	っぺい
fpya	っぴゃ
fpyd	っぴぇん
fpyf	っぴょう
fpyh	っぴゅう
fpyj	っぴゅん
fpyl	っぴょん
fpyn	っぴゃん
fpyo	っぴょ
fpyp	っぴょう
fpyq	っぴゃい
fpyu	っぴゅ
fpyw	っぴぇい
fpyz	っぴゃん
fpz	っぱん
fq	ふぁい
fu	ふ
fw	ふぇい
fz	ふぁん
ga	が
gd	げん
ge	げ
gh	ぐう
gi	ぎ
gj	ぐん
gk	ぎん
gl	ごん
gn	がん
go	ご
gp	ごう
gq	がい
gr	がら
gt	ごと
gu	ぐ
gw	げい
gya	ぎゃ
gyd	ぎぇん
gye	ぎぇ
gyh	ぎゅう
gyj	ぎゅん
gyl	ぎょん
gyn	ぎゃん
gyo	ぎょ
gyp	ぎょう
gyq	ぎゃい
gyu	ぎゅ
gyw	ぎぇい
gyz	ぎゃん
gz	がん
ha	は
hba	ふば
hbd	ふべん
hbe	ふべ
hbh	ふぶう
hbi	ふび
hbj	ふぶん
hbk	ふびん
hbl	ふぼん
hbn	ふばん
hbo	ふぼ
hbp	ふぼう
hbq	ふばい
hbu	ふぶ
hbw	ふべい
hbya	ふびゃ
hbyh	ふびゅう
hbyo	ふびょ
hbyp	ふびょう
hbyu	ふびゅ
hbz	ふばん
hd	へん
he	へ
hf	ふ
hga	ひゃ
hgd	ひぇん
hge	ひぇ
hgh	ひゅう
hgj	ひゅん
hgl	ひょん
hgn	ひゃん
hgo	ひょ
hgp	ひょう
hgq	ひゃい
hgu	ひゅ
hgw	ひぇい
hgz	ひゃん
hh	ふう
hi	ひ
hj	ふん
hk	ひん
hl	ほん
hn	はん
ho	ほ
hp	ほう
hq	はい
hra	ふら
hrd	ふれん
hre	ふれ
hrh	ふるう
hri	ふり
hrj	ふるん
hrk	ふりん
hrl	ふろん
hrn	ふらん
hro	ふろ
hrp	ふろう
hrq	ふらい
hru	ふる
hrw	ふれい
hrya	ふりゃ
hryh	ふりゅう
hryo	ふりょ
hryp	ふりょう
hryu	ふりゅ
hrz	ふらん
hta	ふた
htd	ふてん
hte	ふて
htga	ふつぁ
htge	ふつぇ
htgi	ふてぃ
htgj	ふとぅん
htgk	ふてぃん
htgu	ふとぅ
hth	ふつう
hti	ふち
htj	ふつん
htk	ふちん
htl	ふとん
htn	ふたん
hto	ふと
htp	ふとう
htq	ふたい
htu	ふつ
htw	ふてい
htya	ふつぁ
htye	ふつぇ
htyi	ふてぃ
htyj	ふとぅん
htyk	ふてぃん
htyu	ふとぅ
htz	ふたん
hu	ふ
hw	へい
hya	ひゃ
hyd	ひぇん
hye	ひぇ
hyh	ひゅう
hyj	ひゅん
hyl	ひょん
hyn	ひゃん
hyo	ひょ
hyp	ひょう
hyq	ひゃい
hyu	ひゅ
hyw	ひぇい
hyz	ひゃん
hz	はん
i	い
ja	じゃ
jba	じゅば
jbh	じゅぶう
jbj	じゅぶん
jbl	じゅぼん
jbn	じゅばん
jbo	じゅぼ
jbp	じゅぼう
jbq	じゅばい
jbu	じゅぶ
jbz	じゅばん
jca	じゅちゃ
jcf	じゅちぇ
jch	じゅちゅう
jco	じゅちょ
jcp	じゅちょう
jcu	じゅちゅ
jd	じぇん
je	じぇ
jf	じゅ
jh	じゅう
ji	じ
jj	じゅん
jk	じん
jl	じょん
jn	じゃん
jo	じょ
jp	じょう
jq	じゃい
jra	じゅら
jrh	じゅるう
jrj	じゅるん
jrl	じゅろん
jrn	じゅらん
jro	じゅろ
jrp	じゅろう
jrq	じゅらい
jru	じゅる
jrz	じゅらん
jta	じゅた
jth	じゅつう
jtj	じゅつん
jtl	じゅとん
jtn	じゅたん
jto	じゅと
jtp	じゅとう
jtq	じゅたい
jtu	じゅつ
jtz	じゅたん
ju	じゅ
jw	じぇい
jxa	じゅしゃ
jxf	じゅしゃ
jxh	じゅしゅう
jxo	じゅしょ
jxp	じゅしょう
jxu	じゅしゅ
jz	じゃん
ka	か
kba	きば
kbd	きべん
kbe	きべ
kbh	きぶう
kbi	きび
kbj	きぶん
kbk	きびん
kbl	きぼん
kbn	きばん
kbo	きぼ
kbp	きぼう
kbq	きばい
kbu	きぶ
kbw	きべい
kbya	きびゃ
kbyh	きびゅう
kbyo	きびょ
kbyp	きびょう
kbyu	きびゅ
kbz	きばん
kca	きちゃ
kcf	きちぇ
kch	きちゅう
kco	きちょ
kcp	きちょう
kcu	きちゅ
kd	けん
ke	け
kf	き
kga	きゃ
kgd	きぇん
kge	きぇ
kgh	きゅう
kgj	きゅん
kgl	きょん
kgn	きゃん
kgo	きょ
kgp	きょう
kgq	きゃい
kgu	きゅ
kgw	きぇい
kgz	きゃん
kh	くう
ki	き
kj	くん
kk	きん
kl	こん
kma	くま
kmd	くめん
kme	くめ
kmf	くむ
kmga	くみゃ
kmgh	くみゅう
kmgo	くみょ
kmgp	くみょう
kmgu	くみゅ
kmh	くむう
kmi	くみ
kmj	くむん
kmk	くみん
kml	くもん
kmn	くまん
kmo	くも
kmp	くもう
kmq	くまい
kmta	くむた
kmtd	くむてん
kmte	くむて
kmth	くむつう
kmti	くむち
kmtj	くむつん
kmtk	くむちん
kmtl	くむとん
kmtn	くむたん
kmto	くむと
kmtp	くむとう
kmtq	くむたい
kmtu	くむつ
kmtw	くむてい
kmtz	くむたん
kmu	くむ
kmw	くめい
kmz	くまん
kn	かん
ko	こ
kp	こう
kq	かい
kra	きら
krd	きれん
kre	きれ
krh	きるう
kri	きり
krj	きるん
krk	きりん
krl	きろん
krn	きらん
kro	きろ
krp	きろう
krq	きらい
krr	きられ
krs	きられ
kru	きる
krw	きれい
krya	きりゃ
kryh	きりゅう
kryo	きりょ
kryp	きりょう
kryu	きりゅ
krz	きらん
kta	きた
ktd	きてん
kte	きて
ktga	きつぁ
ktge	きつぇ
ktgi	きてぃ
ktgj	きとぅん
ktgk	きてぃん
ktgu	きとぅ
kth	きつう
kti	きち
ktj	きつん
ktk	きちん
ktl	きとん
ktm	きため
ktn	きたん
kto	きと
ktp	きとう
ktq	きたい
ktt	きたち
ktu	きつ
ktw	きてい
ktya	きつぁ
ktye	きつぇ
ktyi	きてぃ
ktyj	きとぅん
ktyk	きてぃん
ktyu	きとぅ
ktz	きたん
ku	く
kw	けい
kxa	きしゃ
kxf	きしゃ
kxh	きしゅう
kxo	きしょ
kxp	きしょう
kxra	きしゃら
kxrd	きしゃれん
kxre	きしゃれ
kxrh	きしゃるう
kxri	きしゃり
kxrj	きしゃるん
kxrk	きしゃりん
kxrl	きしゃろん
kxrn	きしゃらん
kxro	きしゃろ
kxrp	きしゃろう
kxrq	きしゃらい
kxru	きしゃる
kxrw	きしゃれい
kxrya	きしゃりゃ
kxryh	きしゃりゅう
kxryo	きしゃりょ
kxryp	きしゃりょう
kxryu	きしゃりゅ
kxrz	きしゃらん
kxta	きしゃた
kxtd	きしゃてん
kxte	きしゃて
kxtga	きしゃつぁ
kxtge	きしゃつぇ
kxtgi	きしゃてぃ
kxtgj	きしゃとぅん
kxtgk	きしゃてぃん
kxtgu	きしゃとぅ
kxth	きしゃつう
kxti	きしゃち
kxtj	きしゃつん
kxtk	きしゃちん
kxtl	きしゃとん
kxtn	きしゃたん
kxto	きしゃと
kxtp	きしゃとう
kxtq	きしゃたい
kxtu	きしゃつ
kxtw	きしゃてい
kxtya	きしゃつぁ
kxtye	きしゃつぇ
kxtyi	きしゃてぃ
kxtyj	きしゃとぅん
kxtyk	きしゃてぃん
kxtyu	きしゃとぅ
kxtz	きしゃたん
kxu	きしゅ
kya	きゃ
kyd	きぇん
kye	きぇ
kyh	きゅう
kyj	きゅん
kyl	きょん
kyn	きゃん
kyo	きょ
kyp	きょう
kyq	きゃい
kyu	きゅ
kyw	きぇい
kyz	きゃん
kz	かん
la	ぁ
lc	こく
ld	である
le	ぇ
lh	ぅう
li	ぃ
lj	ぅん
lk	ぃん
ll	ぉん
lm	かも
ln	ぁん
lo	ぉ
lp	ぉう
lq	ぁい
lr	から
lt	こと
lu	ぅ
lw	ぇい
lya	ゃ
lyh	ゅう
lyj	ゅん
lyl	ょん
lyn	ゃん
lyo	ょ
lyp	ょう
lyq	ゃい
lyu	ゅ
lyz	ゃん
lz	ぁん
ma	ま
mba	むば
mbd	むべん
mbe	むべ
mbh	むぶう
mbi	むび
mbj	むぶん
mbk	むびん
mbl	むぼん
mbn	むばん
mbo	むぼ
mbp	むぼう
mbq	むばい
mbu	むぶ
mbw	むべい
mbya	むびゃ
mbyh	むびゅう
mbyo	むびょ
mbyp	むびょう
mbyu	むびゅ
mbz	むばん
mca	むちゃ
mcf	むちぇ
mch	むちゅう
mco	むちょ
mcp	むちょう
mcu	むちゅ
md	めん
me	め
mf	む
mga	みゃ
mgd	みぇん
mge	みぇ
mgh	みゅう
mgj	みゅん
mgl	みょん
mgn	みゃん
mgo	みょ
mgp	みょう
mgq	みゃい
mgu	みゅ
mgw	みぇい
mgz	みゃん
mh	むう
mi	み
mj	むん
mk	みん
ml	もん
mn	もの
mo	も
mp	もう
mq	まい
mra	むら
mrd	むれん
mre	むれ
mrh	むるう
mri	むり
mrj	むるん
mrk	むりん
mrl	むろん
mrn	むらん
mro	むろ
mrp	むろう
mrq	むらい
mrr	むられ
mrs	むられ
mru	むる
mrw	むれい
mrya	むりゃ
mryh	むりゅう
mryo	むりょ
mryp	むりょう
mryu	むりゅ
mrz	むらん
ms	ます
mta	むた
mtd	むてん
mte	むて
mtga	むつぁ
mtge	むつぇ
mtgi	むてぃ
mtgj	むとぅん
mtgk	むてぃん
mtgu	むとぅ
mth	むつう
mti	むち
mtj	むつん
mtk	むちん
mtl	むとん
mtm	むため
mtn	むたん
mto	むと
mtp	むとう
mtq	むたい
mtt	むたち
mtu	むつ
mtw	むてい
mtya	むつぁ
mtye	むつぇ
mtyi	むてぃ
mtyj	むとぅん
mtyk	むてぃん
mtyu	むとぅ
mtz	むたん
mu	む
mw	めい
mxa	むしゃ
mxf	むしゃ
mxh	むしゅう
mxo	むしょ
mxp	むしょう
mxra	むしゃら
mxrd	むしゃれん
mxre	むしゃれ
mxrh	むしゃるう
mxri	むしゃり
mxrj	むしゃるん
mxrk	むしゃりん
mxrl	むしゃろん
mxrn	むしゃらん
mxro	むしゃろ
mxrp	むしゃろう
mxrq	むしゃらい
mxru	むしゃる
mxrw	むしゃれい
mxrya	むしゃりゃ
mxryh	むしゃりゅう
mxryo	むしゃりょ
mxryp	むしゃりょう
mxryu	むしゃりゅ
mxrz	むしゃらん
mxta	むしゃた
mxtd	むしゃてん
mxte	むしゃて
mxtga	むしゃとぅん
mxtge	むしゃつぁ
mxtgj	むしゃてぃん
mxtgk	むしゃとぅ
mxtgu	むしゃてぃ
mxth	むしゃつう
mxti	むしゃち
mxtj	むしゃつん
mxtk	むしゃちん
mxtl	むしゃとん
mxtn	むしゃたん
mxto	むしゃと
mxtp	むしゃとう
mxtq	むしゃたい
mxtu	むしゃつ
mxtw	むしゃてい
mxtya	むしゃつぁ
mxtye	むしゃつぇ
mxtyi	むしゃてぃ
mxtyj	むしゃとぅん
mxtyk	むしゃてぃん
mxtyu	むしゃとぅ
mxtz	むしゃたん
mxu	むしゅ
mya	みゃ
myd	みぇん
mye	みぇ
myh	みゅう
myj	みゅん
myl	みょん
myn	みゃん
myo	みょ
myp	みょう
myq	みゃい
myu	みゅ
myw	みぇい
myz	みゃん
mz	まん
na	な
nb	ねば
nd	ねん
ne	ね
nf	ぬ
nga	にゃ
ngd	にぇん
nge	にぇ
ngh	にゅう
ngj	にゅん
ngl	にょん
ngn	にゃん
ngo	にょ
ngp	にょう
ngq	にゃい
ngu	にゅ
ngw	にぇい
ngz	にゃん
nh	ぬう
ni	に
nj	ぬん
nk	にん
nl	のん
nn	ん
no	の
np	のう
nq	ない
nr	なる
nt	にち
nu	ぬ
nw	ねい
nya	にゃ
nyd	にぇん
nye	にぇ
nyh	にゅう
nyj	にゅん
nyl	にょん
nyn	にゃん
nyo	にょ
nyp	にょう
nyq	にゃい
nyu	にゅ
nyw	にぇい
nyz	にゃん
nz	なん
o	お
pa	ぱ
pd	ぺん
pe	ぺ
pf	ぽん
pga	ぴゃ
pgd	ぴぇん
pge	ぴぇ
pgh	ぴゅう
pgj	ぴゅん
pgl	ぴょん
pgn	ぴゃん
pgo	ぴょ
pgp	ぴょう
pgq	ぴゃい
pgu	ぴゅ
pgw	ぴぇい
pgz	ぴゃん
ph	ぷう
pi	ぴ
pj	ぷん
pk	ぴん
pl	ぽん
pn	ぱん
po	ぽ
pp	ぽう
pq	ぱい
pu	ぷ
pw	ぺい
pya	ぴゃ
pyd	ぴぇん
pye	ぴぇ
pyh	ぴゅう
pyj	ぴゅん
pyl	ぴょん
pyn	ぴゃん
pyo	ぴょ
pyp	ぴょう
pyq	ぴゃい
pyu	ぴゅ
pyw	ぴぇい
pyz	ぴゃん
pz	ぱん
q	ん
ra	ら
rd	れん
re	れ
rh	るう
ri	り
rj	るん
rk	りん
rl	ろん
rn	らん
ro	ろ
rp	ろう
rq	らい
rr	られ
rs	られ
ru	る
rw	れい
rya	りゃ
ryd	りぇん
rye	りぇ
ryh	りゅう
ryj	りゅん
ryl	りょん
ryn	りゃん
ryo	りょ
ryp	りょう
ryq	りゃい
ryu	りゅ
ryw	りぇい
ryz	りゃん
rz	らん
sa	さ
sd	せん
se	せ
sf	さい
sh	すう
si	し
sj	すん
sk	しん
sl	そん
sn	さん
so	そ
sp	そう
sq	さい
sr	する
st	した
su	す
sw	せい
sya	しゃ
syd	しぇん
sye	しぇ
syh	しゅう
syj	しゅん
syl	しょん
syn	しゃん
syo	しょ
syp	しょう
syq	しゃい
syu	しゅ
syw	しぇい
syz	しゃん
sz	さん
ta	た
tb	たび
td	てん
te	て
tgi	てぃ
tgj	とぅん
tgk	てぃん
tgu	とぅ
th	つう
ti	ち
tj	つん
tk	ちん
tl	とん
tm	ため
tn	たん
to	と
tp	とう
tq	たい
tr	たら
tsa	つぁ
tse	つぇ
tt	たち
tu	つ
tw	てい
tya	つぁ
tye	つぇ
tyi	てぃ
tyj	とぅん
tyk	てぃん
tyu	とぅ
tz	たん
u	う
va	ヴぁ
vd	ヴぇん
ve	ヴぇ
vh	ヴう
vi	ヴぃ
vj	ヴん
vk	ヴぃん
vl	ヴぉん
vn	ヴぁん
vo	ヴぉ
vp	ヴぉー
vq	ヴぁい
vu	ヴ
vw	ヴぇい
vz	ヴぁん
wa	わ
wd	うぇん
we	うぇ
wf	わざ
wi	うぃ
wk	うぃん
wl	うぉん
wn	わん
wo	を
wp	うぉー
wq	わい
wr	われ
wsl	うぉん
wso	うぉ
wsq	うぉー
wt	わた
ww	うぇい
wyk	うけ
wyo	うぉ
xa	しゃ
xba	しゃば
xbd	しゃべん
xbe	しゃべ
xbh	しゃぶう
xbi	しゃび
xbj	しゃぶん
xbk	しゃびん
xbl	しゃぼん
xbn	しゃばん
xbo	しゃぼ
xbp	しゃぼう
xbq	しゃばい
xbu	しゃぶ
xbw	しゃべい
xbya	しゃびゃ
xbyd	しゃびぇん
xbye	しゃびぇ
xbyh	しゃびゅう
xbyj	しゃびゅん
xbyl	しゃびょん
xbyn	しゃびゃん
xbyo	しゃびょ
xbyp	しゃびょう
xbyq	しゃびゃい
xbyu	しゃびゅ
xbyw	しゃびぇい
xbyz	しゃびゃん
xbz	しゃばん
xca	しゃちゃ
xcd	しゃちぇん
xce	しゃちぇ
xch	しゃちゅう
xci	しゃち
xcj	しゃちゅん
xck	しゃちん
xcl	しゃちょん
xcn	しゃちゃん
xco	しゃちょ
xcp	しゃちょう
xcq	しゃちゃい
xcu	しゃちゅ
xcw	しゃちぇい
xcz	しゃちゃん
xd	しぇん
xe	しぇ
xf	しゃ
xga	しゃが
xgd	しゃげん
xge	しゃげ
xgh	しゃぐう
xgi	しゃぎ
xgj	しゃぐん
xgk	しゃぎん
xgl	しゃごん
xgn	しゃがん
xgo	しゃご
xgp	しゃごう
xgq	しゃがい
xgu	しゃぐ
xgw	しゃげい
xgz	しゃがん
xh	しゅう
xj	しゅん
xl	しょん
xn	しゃん
xo	しょ
xp	しょう
xq	しゃい
xra	しゃら
xrd	しゃれん
xre	しゃれ
xrh	しゃるう
xri	しゃり
xrj	しゃるん
xrk	しゃりん
xrl	しゃろん
xrn	しゃらん
xro	しゃろ
xrp	しゃろう
xrq	しゃらい
xru	しゃる
xrw	しゃれい
xrya	しゃりゃ
xryd	しゃりぇん
xrye	しゃりぇ
xryh	しゃりゅう
xryj	しゃりゅん
xryl	しゃりょん
xryn	しゃりゃん
xryo	しゃりょ
xryp	しゃりょう
xryq	しゃりゃい
xryu	しゃりゅ
xryw	しゃりぇい
xryz	しゃりゃん
xrz	しゃらん
xta	しゃた
xtd	しゃてん
xte	しゃて
xth	しゃつう
xti	しゃち
xtj	しゃつん
xtk	しゃちん
xtl	しゃとん
xtn	しゃたん
xto	しゃと
xtp	しゃとう
xtq	しゃたい
xtu	しゃつ
xtw	しゃてい
xtz	しゃたん
xu	しゅ
xv	しゃい
xw	しぇい
xz	しゃん
ya	や
yf	ゆ
yh	ゆう
yj	ゆん
yl	よん
yn	やん
yo	よ
yp	よう
yq	やい
yr	よる
yu	ゆ
yz	やん
za	ざ
zba	ざば
zbd	ざべん
zbe	ざべ
zbh	ざぶう
zbi	ざび
zbj	ざぶん
zbk	ざびん
zbl	ざぼん
zbn	ざばん
zbo	ざぼ
zbp	ざぼう
zbq	ざばい
zbu	ざぶ
zbw	ざべい
zbya	ざびゃ
zbyh	ざびゅう
zbyo	ざびょ
zbyp	ざびょう
zbyu	ざびゅ
zbz	ざばん
zc	ぜ
zd	ぜん
ze	ぜ
zf	ざ
zga	ざが
zgd	ざげん
zge	ざげ
zgh	ざぐう
zgi	ざぎ
zgj	ざぐん
zgk	ざぎん
zgl	ざごん
zgn	ざがん
zgo	ざご
zgp	ざごう
zgq	ざがい
zgu	ざぐ
zgw	ざげい
zgya	ざぎゃ
zgyh	ざぎゅう
zgyo	ざぎょ
zgyp	ざぎょう
zgyu	ざぎゅ
zgz	ざがん
zh	ずう
zi	じ
zj	ずん
zk	じん
zl	ぞん
zn	ざん
zo	ぞ
zp	ぞう
zq	ざい
zra	ざら
zrd	ざれん
zre	ざれ
zrh	ざるう
zri	ざり
zrj	ざるん
zrk	ざりん
zrl	ざろん
zrn	ざらん
zro	ざろ
zrp	ざろう
zrq	ざらい
zru	ざる
zrw	ざれい
zrya	ざりゃ
zryh	ざりゅう
zryo	ざりょ
zryp	ざりょう
zryu	ざりゅ
zrz	ざらん
zta	ざた
ztd	ざてん
zte	ざて
ztga	ざつぁ
ztge	ざつぇ
ztgi	ざてぃ
ztgj	ざとぅん
ztgk	ざてぃん
ztgu	ざとぅ
zth	ざつう
zti	ざち
ztj	ざつん
ztk	ざちん
ztl	ざとん
ztn	ざたん
zto	ざと
ztp	ざとう
ztq	ざたい
ztu	ざつ
ztw	ざてい
ztya	ざつぁ
ztye	ざつぇ
ztyi	ざてぃ
ztyj	ざとぅん
ztyk	ざてぃん
ztyu	ざとぅ
ztz	ざたん
zu	ず
zv	ざい
zw	ざわ
zx	ぜい
zya	じゃ
zyd	じぇん
zye	じぇ
zyh	じゅう
zyj	じゅん
zyl	じょん
zyn	じゃん
zyo	じょ
zyp	じょう
zyq	じゃい
zyu	じゅ
zyw	じぇい
zyz	じゃん
zz	ざん
